


NO ./textures/wall1.xpm
SO ./textures/wall2.xpm
WE ./textures/wall3.xpm

EA ./textures/wall4.xpm

F 0,76,211
C 16,255,3


					 
        1111111111111111111111111
        1000000000110000001000001
        1011000001110000000000001
       11001000000000000000000001
111111110011000001110000000000001
100000011111110000111011111111111
111101111     1111011100000010001
111101111111110111010100100011111
1100000011010101110000001000111
1000000000000000110000001000111
1000000000000000110101001000111
11000001110101011111011110N0111
111111111111111111111111111111
11111111    111111  111111111 1
