NO   		   ./textures/wall3.xpm
SO 		   ./textures/wall1.xpm

WE ./textures/wall2.xpm

C 145,120,255
EA ./textures/wall4.xpm

F 255,80,120

		1111111111111111111111111
		100000000110000000010001
		1011000001110000000000001
		1001000000000000000000001
111111111011000001110000000000001
100000000011000001110111111111111
11110111111111011 100000010001
11110111111111011 101010010001
110000S0110101011 100000010001
1000000000000001 100000010001
10000000000000001 101010010001
11000001110101011111011110001 1 
11110111  111111110101 101111101
11111111111111111111111111111111