


NO ./textures/wall1.xpm
SO ./textures/wall2.xpm
WE ./textures/wall3.xpm

EA ./textures/wall4.xpm


F 0,76,211
C 16,255,3


111111111111111111111111
100000000000000000000001
11100000100010011111111
111111111000000000000011
100000000000000000000001
11111111111111111111111111
