


NO ./textures/wall1.xpm
SO ./textures/wall2.xpm
WE ./textures/wall3.xpm

EA ./textures/wall4.xpm

F 0,76,211
C 16,255,3


           111111111111111111111111
           100000000000000000000001
           111000002000100N11111111
11111111111000000000001111111111111
100000000000000000000001
10000000000000000000000011111
1000000000000000000000000001
11111111111111111111111111111
